  #### 
 ##  # 
###  # 
#   @##
# *$. #
###   #
 ######
Title: 06