 ####   
 #  ####
 #$    #
##@.#  #
#  #. ##
#    $# 
####  # 
   ####
Title: 06