  ##### 
###   # 
#   # # 
#  $$ # 
### .@##
  # .  #
  #    #
  ######
Title:sth