#####   
#   ####
#      #
##  #  #
 #@.*$##
 ###  # 
   #  # 
   #### 
Title:sth