########
#   #  #
#      #
# # #. #
#  $$.@#
###  ###
  #  #  
  ####  
Title:sth