####    
#  #####
# . #  #
# $*$  #
##  .@ #
 ####  #
    #  #
    ####    
Title:sth