   #####
   #   #
####.  #
#  $.@ #
#  *$ ##
##  ### 
 #  #   
 ####   
Title:sth