 #######
 #  #  #
##  #  #
#  $.  #
# @.$ ##
###$.## 
  #  #  
  ####  
Title:sth