####### 
#     ##
#      #
## ##  #
 #$.$.@#
 #  #  #
 #  ####
 ####   
Title:sth