 ####   
 #  #   
 #  #   
 #  ####
###$$  #
#   .*@#
#   .###
######   
Title:sth