 ####   
 #  #   
 #  ####
##$$.. #
#    # #
#  #@  #
#  #####
####   
Title:sth