  ####  
###  ###  
###  ###
# $*.@ #
#      #
########
########
Title: 06