#####   
#   ##  
# #  #  
#  .$###
## #   #
#  $.@ #
#   #  #
########
Title:sth