 ####   
 #  #   
 # .#   
##$@#   
# $ ####
#  .   #
####   #
   #####
Title:sth