########
#   #  #
#  .   #
##$##  #
# @.#  #
# $    #
#####  #
    ####
Title:sth