 ####   
 #  #   
 #  ####
##     #
# $**.@#
#  #   #
#  #####
####    
Title:sth