   #### 
   #  ##
####   #
#  $$  #
# ..@###
# #   # 
#     # 
#######         
Title:sth