   #### 
####  ##
# .    #
# $#   #
#  # ###
##$.@ # 
 #    # 
 ###### 
Title:sth