 ####   
 #  #   
 #  ####
##$$.. #
#   @# #
#  #   #
#  #####
####    
Title:sth