 #####  
 #   #  
 # # ###
## .$. #
#  $+$ #
#  ##  #
#  #####
####    
Title:sth