    ####
    #  #
#####  #
#  .$. #
#  $.$##
####@  #
   #   #
   #####
Title:sth