 #######
## @   #
# $.   #
# .$####
##  ####   
##  ####   
######## 
Title: 06