 ##### 
 #   ##
##  @ #
# $#. #
# $ .##
#    # 
######
Title: 06