 ####   
 #  #   
##.$####
#@.$   #
# .$#  #
##     #
 #  #  #
 #######
Title:sth