#####   
#   ##  
#    ## 
###$* ##
### .@ #
#      #
#   #  #
########
Title:sth