   #### 
####  # 
#  #  # 
#  .$ ##
#   #  #
###$.@ #
  #  ###
  ####  
Title:sth