  ####  
  #  #  
###$.## 
# *@  ##
# #$.  #
#      #
##  ####
 ####     
Title:sth