  ##### 
  #   # 
  #.  ##
###$$* #
# @.#  #
#      #
#  #  ##
####### 
Title:sth