####    
#  #    
# @#    
#.$#####
#      #
#.$# # #
#  #   #
########
Title:sth