######  
#    #  
#    #  
###.$###
###$.@ #
#  .$  #
#   ####
#####   
Title:sth