########
#  *@  #
#  $.  #
###  ###
###  ###  
########
########
Title: 06