  ####  
  #  ###
###$.@ #
#   #  #
#  $. ##
#  #  # 
####  # 
   #### 
Title:sth