 ####
 #  #
##  ###
#   @ ##
# $$$  #
#  #  .#
#####..#
    ####
Title:sth