 ####   
##  #   
# . ### 
# $   ##
# $#   #
# .@ # #
####   #
   #####
Title:sth