 ####
 #  #
 #  ####
##  .. #
# $$$ @#
#  # . #
#  #####
####
Title:sth