   #### 
   #  # 
####  # 
#  $$ # 
# ..@###
#      #
#  #   #
########
Title:sth