 ####   
 #@ ##  
 #*$.#  
 #.$ ###
## #   #
#      #
#   ####
#####   
Title:sth