  ####  
  #  #  
###  ###
# $$$  #
#@.. . #
## # ###
 #   #  
 #####  
Title:sth