####    
#  #    
#  #####
#      #
##@.#$ #
#   #  #
#   ####
#####   
Title:sth