#####   
#   #   
#   ####
##$$ $ #
 #+. . #
 #  ####
 #  #   
 ####   
Title:sth