   #### 
####  # 
#  . $# 
#  $@.##
####   #
   # # #
   #   #
   #####
Title:sth