 ####   
 #  #   
##  ### 
#   @ ##
# $**. #
#  #   #
#####  #
    ####
Title:sth