  ####  
###  ###
#   .  #
# #+$  #
#  *$###
###  #  
  #  #  
  ####  
Title:sth