  #### 
###  ## 
#  *@## 
#  $.##
###   #
###   #
  #####
Title: 06