####    
#  #####
#  #   #
#  .$#@#
#   .$ #
# *#####
#  #    
####     
Title:sth