   #####
 ###   #
 #.  # #
##+$$$ #
# .#  ##
#    ## 
#  ###  
####    
Title:sth