   #####
####   #
# .    #
# $*$ ##
###@.## 
  #  #  
  #  #  
  ####  
Title:sth