  ####  
  #  #  
  # .#  
###$+###
#  $*  #
#      #
#  ##  #
########
Title:sth