########
#  #   #
#  # # #
# $$ $ #
##+. .##
 #  ### 
 #  #   
 ####     
Title:sth